   "       ....       " +
                    "     .   ....     " +
                    "   .       ....   " +
                    " .           .... " +
                    ".      .      ...." +
                    ".      .      ...." +
                    ".      .      ...." +
                    "  .     .   ....  " +
                    "    .     ....    " +
                    "  .   .     ....  " +
                    ".      .      ...." +
                    ".      .      ...." +
                    ".      .      ...." +
                    " .           .... " +
                    "   .       ....   " +
                    "     .   ....     " +
                    "        ....      "